16 10 17 0 9 0 0 0 0 0 5 1 23 1 7 1 1 1 6 0 
0 0 0 0 9 0 0 0 0 0 2 0 23 0 7 0 0 0 2 0 
22 10 20 0 9 0 5 1 1 1 7 0 23 0 0 0 8 0 2 0 
0 0 0 0 9 0 2 0 0 0 0 0 23 0 7 0 0 0 2 0 
11 10 12 0 9 0 2 0 0 0 0 0 23 7 7 1 1 1 3 0 
0 0 0 0 9 0 2 0 0 0 7 0 23 23 23 23 23 23 23 23 
9 9 9 9 9 0 4 1 1 1 7 0 0 0 0 7 0 0 0 0 
0 0 0 0 14 0 0 0 0 0 2 0 18 10 17 2 0 0 0 0 
0 0 0 0 10 0 0 0 0 0 2 0 0 0 0 2 0 0 0 0 
0 0 0 0 13 0 0 0 0 0 4 1 1 1 1 3 0 0 0 0 
0 0 0 0 0 0 0 0 0 0 0 0 0 0 0 0 0 0 0 0
512
256