0 0 0 0 5 1 1 1 1 1 1 1 1 1 6 0 0 0 0 0 
0 0 0 0 2 0 0 0 0 0 0 0 0 0 2 0 0 0 0 0 
0 11 0 0 2 0 0 23 0 0 0 18 0 0 2 0 0 0 0 0 
0 10 0 0 2 23 23 23 0 0 0 10 0 0 2 0 0 0 0 0 
0 12 0 0 2 0 0 0 0 0 0 20 0 0 2 0 0 0 0 0 
0 0 0 0 2 0 0 0 0 0 0 0 0 0 2 0 0 0 0 0 
0 0 0 0 2 0 22 10 17 0 0 0 0 0 2 0 0 0 0 0 
0 0 0 0 2 0 0 0 0 0 0 0 0 0 2 0 0 0 0 0 
0 0 0 0 4 1 1 1 1 1 1 1 1 1 3 0 0 0 0 0 
0 0 0 0 0 0 0 0 0 0 0 0 0 0 0 0 0 0 0 0 
0 0 0 18 10 17 0 0 14 10 13 0 0 0 0 0 0 0 0 0
320
64