0 0 5 1 1 1 1 1 1 1 1 1 1 1 1 1 1 6 0 0 
0 0 2 0 0 0 0 9 0 0 0 0 0 0 0 0 0 2 0 0 
0 0 2 0 14 10 13 0 0 0 0 0 0 0 0 0 0 2 0 0 
0 0 2 9 0 0 0 0 0 0 9 0 0 8 0 0 0 2 0 0 
0 0 2 0 0 0 0 0 0 0 0 9 0 0 0 0 0 2 0 0 
0 0 2 0 0 0 0 0 0 0 0 0 9 0 9 0 0 2 0 16 
0 0 2 0 0 0 0 0 0 0 9 0 0 9 0 9 9 2 0 10 
0 0 2 9 0 0 0 0 0 0 9 0 11 0 12 0 0 2 0 17 
0 0 2 0 9 0 0 0 0 0 9 0 0 9 0 0 0 2 0 0 
0 0 2 0 0 0 0 0 9 0 0 9 0 0 0 0 0 2 0 0 
0 0 4 1 1 1 1 1 1 1 1 1 1 1 1 1 1 3 0 0
384
320