0 0 0 0 0 0 0 5 1 1 1 1 6 0 0 0 0 0 0 0
0 0 0 0 0 0 0 2 0 0 0 0 2 0 0 0 0 0 0 0
0 0 0 0 0 0 0 2 0 11 0 0 2 14 10 13 0 0 0 0
0 0 0 0 0 0 0 2 0 0 0 0 2 0 0 0 0 0 0 0
0 0 0 0 0 0 0 2 0 0 0 0 2 0 0 0 0 0 0 0
0 5 1 1 1 1 1 7 0 0 0 0 4 1 1 1 1 1 6 0
0 2 0 18 0 0 0 2 0 0 0 0 0 0 0 0 0 0 2 0
0 2 0 10 0 0 0 2 0 0 8 0 0 0 0 0 10 0 2 0
0 2 0 17 0 0 0 2 0 0 0 12 0 0 0 0 0 0 2 0
0 2 0 0 0 0 0 2 0 0 0 0 0 0 0 0 0 0 2 0
0 4 1 1 1 1 1 7 1 1 1 1 1 1 1 1 1 1 3 0
256
448
