11 10 12 0 0 0 0 0 0 0 0 0 0 0 0 0 0 21 10 19 
0 0 0 0 0 0 0 0 0 0 0 0 0 0 0 24 24 24 0 0 
0 0 0 0 0 0 0 0 0 0 0 0 0 0 24 24 0 24 24 0 
0 0 5 1 1 1 6 0 0 0 0 0 0 0 24 0 8 0 24 0 
0 0 2 0 0 0 2 0 0 0 0 0 0 0 24 24 0 24 24 0 
0 0 2 0 0 0 2 0 0 0 0 0 0 0 0 24 24 24 0 0 
0 0 4 7 0 7 3 0 0 0 0 18 0 0 0 0 0 0 0 0 
0 0 0 0 0 0 0 0 0 0 0 0 0 0 0 0 0 0 0 0 
0 0 0 0 7 7 7 0 0 0 0 0 0 0 0 0 0 0 0 0 
0 0 7 0 14 10 13 0 0 0 0 0 0 0 0 0 0 0 0 0 
0 0 7 7 7 7 7 7 7 7 0 0 0 0 0 0 0 18 10 17
256
256