22 0 0 0 0 0 0 8 8 8 8 8 8 0 0 0 0 0 0 0
0 0 0 0 0 0 0 8 0 0 0 0 8 0 0 0 0 0 0 0
0 0 14 10 13 0 0 8 0 14 0 0 8 0 0 0 0 0 0 0
0 0 0 0 0 0 0 8 0 0 0 0 8 0 0 0 0 0 0 0
0 0 0 0 0 0 0 8 0 0 0 0 8 0 0 0 0 0 0 0
0 8 8 8 8 8 8 8 0 0 0 0 8 8 8 8 8 8 8 0
0 8 0 11 0 0 0 8 0 0 0 0 0 0 0 0 0 0 8 0
0 8 0 10 0 0 0 8 0 0 0 0 0 0 0 0 10 0 8 0
0 8 0 17 0 0 0 8 0 0 0 12 0 0 0 0 0 0 8 0
0 8 0 0 0 0 0 8 0 0 0 0 0 0 0 0 0 0 8 0
0 8 8 8 8 8 8 8 8 8 8 8 8 8 8 8 8 8 8 0
